   XXXXX
XX XXXXX
XX    XX
XXXXX XX
D     XX
XX XX XX
XX XX XX
XXXXX XX